lean_against,lean_for,strongly_against,strongly_for,swing_against,Total,total_for_share,total_against_share,total_swing_share
0,29,0,58,0,87,0.0655,0.0,0.0
68,0,0,23,37,128,0.0173,0.0512,0.0279
1,23,91,0,0,115,0.0173,0.0693,0.0
0,12,20,0,36,68,0.009,0.0151,0.0271
18,0,24,15,53,110,0.0113,0.0316,0.0399
16,7,2,0,0,25,0.0053,0.0136,0.0
0,14,0,40,0,54,0.0407,0.0,0.0
0,0,0,17,0,17,0.0128,0.0,0.0
6,0,0,0,0,6,0.0,0.0045,0.0
0,0,0,54,0,54,0.0407,0.0,0.0
109,85,137,207,126,664,0.4398,0.3705,0.1898
